┌─────┬─────────────────────────┬─────────────────┐
│ u  #│                         │      #[_]#     <│
│    O│                         │      #####      │
│    #│                         =        L        │
├──=──┘                         │                 │
│                               │                 │
│    -----  -----               ├────────=────────┤
│                               │                 │
│    -----  -----               │                 │
│                               │                 │
│    -----  -----               │                 │
│                               │                 │
│    -----  -----               │                 │
│                               │                 │
│    -----  -----          ##   │                 │
│                          #$   │                 │
│    -----  -----          ##   │                 │
│                               │                 │
│                               │                 │
└──~~~~~~~──~~~~~~~──==──~~~~~──┴─────────────────┘
